111111111111111111
100E0P00C100000011
100000000010000111
111111111111111111