111111111111
1P01C1111111
1001100000E1
100000000001
111111111111